Adafruit_MQTT	KEYWORD1
Adafruit_MQTT_FONA	KEYWORD1
Adafruit_MQTT_Client	KEYWORD1
Adafruit_MQTT_Publish	KEYWORD1
Adafruit_MQTT_Subscribe	KEYWORD1
connect	KEYWORD2
connectErrorString	KEYWORD2
disconnect	KEYWORD2
connected	KEYWORD2
will	KEYWORD2
publish	KEYWORD2
subscribe	KEYWORD2
unsubscribe	KEYWORD2
readSubscription	KEYWORD2
ping	KEYWORD2
setCallback	KEYWORD2
connectServer	KEYWORD2
disconnectServer	KEYWORD2
readPacket	KEYWORD2
sendPacket	KEYWORD2
